11111111111111111
1P0C0CCC0000C0001
101001101101001C1
1C0011C0000101101
10001110000011101
1C0011C00001011C1
1C0011C1001010011
11001111001001001
1C0011C0001001001
1C0011C0001000E01
10000000000000001
100C0CCC0000C0001
101001101101001C1
1C0011C0000101101
10001110000011101
1C0011C00001011C1
1C0011C1001010011
11001111001001001
1C0011C0001001001
1C0011C0001000001
11111111111111111